#########################
#.M....................o#
#o.....................o#
#.######.........######.#
 M#    #.### ###.#    #{ 
 .#    #.#     #.#    #. 
#.######.#######.######.#
#oM.....M..............o#
#########################