####################
##.....#.#o.#..#...#
#o...#....o.......##
#...#          #.###
#...# ###  ### ....#
 ...# #      # .... 
#.... ######## #...#
####. Mo  }    #...#
#.#.#......#o#.#...#
#......#..#.###...##
####################
