#####################
##.....#.#o.#..#...o#
#...#....o.......#..#
#.##.           #...#
##..# ###   ### ..###
 #..# #       # ..## 
#.... ######### #...#
#.#..    }      #...#
#...#o#.#.........#.#
#.#.###...#.#...#...#
#####################