#####################
##.....#.#o.#..#...o#
#...#           .#..#
#.##. ###   ### #...#
 #..# #       # ..## 
 ...# ######### .... 
#....     }     #...#
#.#....#.#....#.#...#
#...#o#.#.........#.#
#####################
