####################
##.....#.#o.#..#...#
#o...          ...##
#...# ###  ### #.###
 ...# #      # .... 
 ..## ######## .... 
#....   {      #...#
####....#....#.#...#
#.#.#......#o#.#...#
####################
